Actual Close date => actualclosedate
E-Invoice => ss_einvoice
E-Invoice Email => ss_einvoiceemail
Standard Contract Length => ss_standardcontractlength
Auto-Renewal For Subscription => ss_autorenewalforsubscriptionterm
Standard Price Increase => ss_standardpriceincreases
Annual Increase => ss_annualincrease
Cap on Price Increase => ss_caponpriceincreases
Price Increase => ss_newpriceincreases
Other Price Increase => ss_otherpriceincreases
Increase Allowed => ss_increasesallowed
Standard Notification Required => ss_standardnotificationreq
Prepaid => ss_prepaid
Price Increase Annual => ss_priceincreaseannual
Contract Start Date => ss_newcontractstartdate
Contract End Date => ss_newcontractenddate
Contract Period => ss_newcontractperiod
Invoice Date => ss_nextinvoicedate
Termination Period =>ss_newterminationperiod
Official Contract Owner => ss_officialcontractpartner
Standard Payment Terms => ss_standardpaymentterms
Payment Term 14 days => ss_paymentterm14days
Payment Term days => ss_paymenttermdays
Billing Upon signature => ss_billinguponsignature
Reference => ss_reference
Presentaion => ss_presentation
Case Study => ss_casestudy
Forwarding As Recommendatior => ss_forwardingasrecommendatior
Other Specification => ss_otherspecification
Specifcation Details => ss_specificationdetails

